name,brand,url,price,original_price,rating_average,discount,discount_rate,review_count
Tai Nghe Nhét Tai Có Micro JBL C200SI - Hàng Chính Hãng,"""JBL""",https://tiki.vn/product-p214168962.html?spid=214168963,240000,290000,5.0,50000,17,137
Chuột không dây bluetooth Logitech Signature M650 - Hàng chính hãng,"""Logitech""",https://tiki.vn/product-p176899932.html?spid=160666618,619000,910000,5.0,291000,32,694
Chuột Không Dây Logitech M331 Silent - Hàng Chính Hãng,"""Logitech""",https://tiki.vn/product-p299461.html?spid=49020032,319000,319000,4.8,0,0,2121
Lót chuột máy tính PixLink kích thước 22x18cm hàng chính hãng,"""PIX-LINK""",https://tiki.vn/product-p174593826.html?spid=174593829,18000,39000,4.8,21000,54,96
"Chuột không dây Logitech B175 - đầu thu USB 2.4Ghz, pin 1 năm, nhỏ gọn, thiết kế thuận cả 2 tay, phù hợp PC/ Laptop - Hàng chính hãng","""Logitech""",https://tiki.vn/product-p389145.html?spid=11180693,199000,199000,4.5,0,0,75
Que Chọc Sim - Hàng nhập khẩu,"""OEM""",https://tiki.vn/product-p8190056.html?spid=186755185,5000,5000,5.0,0,0,1
Ốp lưng dẻo cho iPhone 8 / SE 2020 / 8 Plus / X / XS / XR / XS Max / 11 / 11 Pro / 11 Pro Max / 12 / 12 Pro / 12 Pro Max / 12 Mini / 13 / 13 Pro / 13 Pro Max / 13 Mini / 14 / 14 Pro / 14 Pro Max / 14 Max -Hàng chính hãng-Photodesign VN,"""Photodesign VN""",https://tiki.vn/product-p195277333.html?spid=195277357,149000,250000,4.7,101000,40,218
Adapter Sạc 1 Cổng USB Type-C 20W - Trắng,"""Apple""",https://tiki.vn/product-p123836523.html?spid=71523845,480000,790000,5.0,310000,39,3065
Tai nghe nhét tai có dây jack 3.5mm Remax RM-512 (New Package) - Hàng chính hãng,"""Remax""",https://tiki.vn/product-p110850007.html?spid=141298218,76000,80000,4.8,4000,5,21
"Kính Cường Lực KingKong Có Khung Tự Dán, Ngăn Bụi Loa Dành Cho iPhone - Full Hộp, Dán Full Màn - Hàng Chính Hãng","""wekome""",https://tiki.vn/product-p227746564.html?spid=243562095,121997,134198,5.0,12201,9,18
Tai Nghe Apple EarPods Cổng USB-C - MTJY3,"""Apple""",https://tiki.vn/product-p272420799.html?spid=272420800,490000,790000,5.0,300000,38,28
Apple AirPods 2 - Hộp Sạc Thường,"""Apple""",https://tiki.vn/product-p123838761.html?spid=12567799,2690000,5390000,4.8,2700000,50,2501
Apple AirPods 3 2022 sạc Lightning - MPNY3,"""Apple""",https://tiki.vn/product-p197665885.html?spid=197665886,3990000,5390000,4.8,1400000,26,183
Tai nghe bluetooth nhét tai chống ồn cao cấp V5.0 chính hãng dùng cho iPhone Samsung OPPO VIVO HUAWEI XIAOMI tai nghe không dây - Hàng Chính Hãng PKCB,"""PKCB""",https://tiki.vn/product-p109393113.html?spid=109393114,239000,500000,4.5,261000,52,1182
[Miễn Phí 12 Tháng] SIM MAX DATA 4G VIETNAMOBILE 6GB/Ngày. Trọn Gói 1 Năm - Hàng Chính Hãng,"""Vietnamobile""",https://tiki.vn/product-p158868703.html?spid=158868704,355000,650000,4.5,295000,45,386
Tai Nghe Apple EarPods Cổng Lightning - MMTN2,"""Apple""",https://tiki.vn/product-p1935009.html?spid=170280931,480000,790000,4.8,310000,39,1047
Adapter Sạc Anker 313 / 311 Charger Gen 2 30W 1 Cổng Type-C A2639 - Hàng Chính Hãng,"""ANKER""",https://tiki.vn/product-p199249541.html?spid=199249545,283000,500000,5.0,217000,43,113
Kính Cường Lực Chống Nhìn Trộm KingKong Dành Cho iPhone - Full Hộp - Dán Full Màn - Hàng Chính Hãng ,"""Kingkong""",https://tiki.vn/product-p80857582.html?spid=189469022,47000,47000,4.5,0,0,37
Tai Nghe Baseus Encok 3.5mm lateral in-ear Wired Earphone H17 - Hàng Chính Hãng,"""Baseus""",https://tiki.vn/product-p181185263.html?spid=271974472,143000,259000,4.5,116000,45,8
"Chuột Không Dây Bluetooth PIX-LINK P100B Chống Ồn, DPI 1600, Chế Độ Kép Wireless Usb 2.4Ghz, Bluetooth Dùng Cho Macbook, Laptop, PC - Hàng chính Hãng","""PIX-LINK""",https://tiki.vn/product-p174593860.html?spid=174593865,135000,299000,4.6,164000,55,265
Tai Nghe Bluetooth Lenovo Livepods LP40 TWS Hàng Chính Hãng,"""Lenovo""",https://tiki.vn/product-p185409732.html?spid=271780839,359000,359000,0.0,0,0,0
Chuột Không Dây Logitech M221 - Hàng Chính Hãng,"""Logitech""",https://tiki.vn/product-p299431.html?spid=31296701,235000,269000,4.8,34000,13,1521
Apple AirPods Pro 2 Lightning - MQD83ZP/A,"""Apple""",https://tiki.vn/product-p197665467.html?spid=197665468,4850000,6990000,4.8,2140000,31,222
Tai Nghe Nhét Tai Sony MDR-EX155AP - Hàng Chính Hãng,"""Sony""",https://tiki.vn/product-p855600.html?spid=858826,349000,390000,4.7,41000,11,1621
"Hub USB 3.0 FIRO Và Hub Type C FIRO - Bộ Chia Cổng USB FIRO - HUB Chuyển Đổi Dành Cho Laptop, PC - Hỗ Trợ Sạc Pin, Kết Nối Đa Năng Ổ Cứng , Bàn Phím, Chuột, Máy In, Thiết Bị Ổ Chia USB - FIRO Type C Adapter 4in1 - Hàng Chính Hãng","""FIRO""",https://tiki.vn/product-p262034792.html?spid=262034793,140000,319000,4.8,179000,56,33
Bộ sạc nhanh cho IP công suất 18W Remax RP-U37 - Hàng chính hãng,"""Remax""",https://tiki.vn/product-p216238849.html?spid=272917423,170000,189000,0.0,19000,10,0
Cáp sạc Baseus Cafule sạc nhanh dùng cho iPhone - Hàng chính hãng,"""Baseus""",https://tiki.vn/product-p142439870.html?spid=142439874,69000,74000,4.8,5000,7,467
"Tai Nghe Bluetooth True Wireless AMOI F9 Cảm Ứng Vân Tay, Nâng Cấp Dock Sạc có Led Báo Pin Kép - Hàng Nhập Khẩu","""AMOI""",https://tiki.vn/product-p191684818.html?spid=210637817,85000,94000,4.5,9000,10,1105
Chuột Không Dây Sạc Pin 2.4GHz PIX-LINK P1 Siêu Mỏng Không Gây Tiếng Ồn Sạc 1 Lần Dùng 1 Tuần Cho Laptop Macbook PC Tivi - Hàng Chính Hãng,"""PIX-LINK""",https://tiki.vn/product-p174593880.html?spid=174593886,76000,159000,4.7,83000,52,63
Adapter Sạc Anker 511 Charger Nano 3 30W 1 Cổng Type-C A2147 - Hàng Chính Hãng,"""ANKER""",https://tiki.vn/product-p199525542.html?spid=199525546,308000,500000,5.0,192000,38,113
Thẻ Nhớ microSD SanDisk Ultra 64GB UHS-I - 100MB/s (New 2020) - Hàng Nhập Khẩu,"""SanDisk""",https://tiki.vn/product-p73315307.html?spid=73315308,119000,119000,4.8,0,0,971
"Giá Đỡ Laptop Hợp Kim Nhôm Cao Cấp Dễ Dàng Gấp Gọn, Giúp Tản Nhiệt Laptop, Máy Tính Xách Tay - 07 Nấc Điều Chỉnh Góc Độ. Hàng Chính Hãng Tamayoko","""Tamayoko""",https://tiki.vn/product-p201437397.html?spid=113829752,196000,250000,4.7,54000,22,290
Cáp sạc và truyền dữ liệu cho IP Remax RC-138i - Hàng chính hãng,"""Remax""",https://tiki.vn/product-p251518027.html?spid=263272322,48999,54999,0.0,6000,11,0
"Pad Lót Chuột Nhiều Hình-Giao màu,hình ngẫu nhiên","""OEM""",https://tiki.vn/product-p46193718.html?spid=67199957,32900,35000,4.6,2100,6,33
Giá đỡ laptop nhôm cao cấp có thể gấp gọn dành cho Macbook Ipad Surface và máy tính xách tay,"""OEM""",https://tiki.vn/product-p273047537.html?spid=107982908,147250,155000,4.7,7750,5,47
Chuột Không Dây Logitech M220 Silent Plus - Hàng Chính Hãng,"""Logitech""",https://tiki.vn/product-p10198980.html?spid=247855978,243000,243000,5.0,0,0,6
Bút laser trình chiếu Slide VSON N35 - Hàng nhập khẩu,"""VSON""",https://tiki.vn/product-p24865067.html?spid=104886482,152000,173000,4.8,21000,12,67
Tai Nghe Nhét Tai Sony Fontopia MDR-E9LP - Hàng Chính Hãng,"""Sony""",https://tiki.vn/product-p125781.html?spid=125798,140000,149000,0.0,9000,6,0
"Lót Chuột FIRO - Miếng Lót Chuột Cỡ Lớn 80cmx40cm - Tấm Lót Chuột, Pad Chuột FIRO Sử Dụng 2 Mặt Tiện Lợi - Chất Liệu Da PU Cao Cấp - Thiết Kế Sang Trọng - Chống Nhăn, Chống Nước, Chống Bám Bụi - Hàng Chính Hãng","""FIRO""",https://tiki.vn/product-p262478106.html?spid=262478114,118000,265000,4.7,147000,55,15
"Dây Cáp Sạc Nhanh Đa Năng 4 in 1 Baseus rapid series 4 in 1 (3.5A, 1.2M, Fast charge 4 in 1 Cable) - 2 đầu dùng cho iPhone - 1 đầu TypeC - 1 đầu micro usb - Hàng Chính Hãng","""Baseus""",https://tiki.vn/product-p152464834.html?spid=243037866,150000,300000,4.8,150000,50,44
Apple Magic Mouse 2021- Silver,"""Apple""",https://tiki.vn/product-p135151945.html?spid=135151946,1450000,3490000,5.0,2040000,58,258
"Tấm Lót Chuột, Thảm Da Trải Bàn Làm Việc VinBuy, Miếng Di Chuột Cỡ Lớn 40cmx80cm - Hàng Chính Hãng ","""VinBuy""",https://tiki.vn/product-p137864606.html?spid=193777817,95000,150000,4.7,55000,37,250
"Tai Nghe Bluetooth Không Dây Cao Cấp EQ1 Pin 7H Âm Thanh Sống Động Bass Chắc Cảm Ứng, Có Mic Đèn Led Sang Trọng - Hàng Chính Hãng","""Hoco""",https://tiki.vn/product-p271995193.html?spid=271995199,313000,500000,4.8,187000,37,26
Chuột Bluetooth Silent Logitech Pebble M350 - Hàng chính hãng,"""Logitech""",https://tiki.vn/product-p67907870.html?spid=105362052,436000,599000,5.0,163000,27,436
Cáp Sạc ANKER PowerLine+ II USB-C to Lightning - Phiên Bản Marvel - A9551 / A9548 - Hàng Chính Hãng,"""ANKER""",https://tiki.vn/product-p195300886.html?spid=195300892,333000,550000,5.0,217000,39,87
CỐC SẠC NHANH 15W 2 CỔNG CHỐNG CHÁY NỔ HOCO C73 - CỦ SẠC ĐA NĂNG 2.4A CHO CÁC DÒNG ĐIỆN THOẠI CHÍNH HÃNG,"""Hoco""",https://tiki.vn/product-p56049649.html?spid=76514573,49000,75000,4.7,26000,35,533
"Cáp sạc nhanh, truyền dữ liệu tốc độ cao Baseus Cafule Type C cho Samsung S8/S9/ Note8/ Note9/ Xiaomi/ Huawei/ Oppo/Nokia ( 3A, Sạc nhanh Quick charge 3.0, Siêu bền)- Hàng nhập khẩu","""Baseus""",https://tiki.vn/product-p35420153.html?spid=83001993,75000,108000,4.8,33000,31,242
"Chuột không dây bluetooth Logitech POP MOUSE - giảm ồn, nút emoji tùy chỉnh - Hàng chính hãng","""Logitech""",https://tiki.vn/product-p173058453.html?spid=173058457,549522,899000,4.8,349478,39,197
Bộ Thu Phát Bluetooth TP-Link UB500 USB Nano Bluetooth 5.0 - Hàng Chính Hãng,"""TP-Link""",https://tiki.vn/product-p134364129.html?spid=164404549,129000,139000,5.0,10000,7,332
"Cáp chuyển đổi Hoco LS30 Type-C to 3.5mm hỗ trợ nghe nhạc, mic đàm thoại thiết kế nhỏ gọn - Hàng chính hãng","""Hoco""",https://tiki.vn/product-p109135965.html?spid=249573699,73000,99000,5.0,26000,26,9
Cáp sạc nhanh PD20W truyền dữ liệu Baseus Metal Data Type-C sang iPhone ( 2 size ) - Hàng chính hãng,"""Baseus""",https://tiki.vn/product-p109455098.html?spid=141647220,93000,139000,5.0,46000,33,45
Cáp Sạc ANKER Powerline+ II USB-C To USB-C Phiên Bản Marvel - A9547 / A9549 - Hàng Chính Hãng,"""ANKER""",https://tiki.vn/product-p195300846.html?spid=195300854,196000,300000,5.0,104000,35,80
Giá Đỡ Điện Thoại Để Bàn Hình Ghế Thời Trang - Giao Màu Ngẫu Nhiên,"""OEM""",https://tiki.vn/product-p25325318.html?spid=173465781,16900,16900,5.0,0,0,9
Bàn phím có dây Logitech K120 - Hàng chính hãng,"""Logitech""",https://tiki.vn/product-p359484.html?spid=22777832,145000,145000,4.8,0,0,365
"Thi.ết bị định vị GPS, Wifi Q08 mini App Miwitracker Độ chính xác cao Hàng nhập khẩu","""AMA""",https://tiki.vn/product-p230082946.html?spid=230082947,1150000,1150000,4.8,0,0,13
"Hub Type-C To HDMI FIRO 6in1 Chuẩn HDTV - Hub Chuyển Đổi Type-C Chia 6 Cổng - 1 Cổng HDMI/HDTV 4K, 2 Cổng USB 3.0, 2 Khe Đọc Thẻ TF Và SD, 1 Cổng Sạc Nhanh Type C PD - Kết Nối Tốc Độ Cao - Dùng Cho Smartphone/Laptop/PC/Tivi/Playstation – Hàng Chính Hãng","""FIRO""",https://tiki.vn/product-p263433314.html?spid=263433315,258000,579000,5.0,321000,55,17
"Kính Cường Lực Đồng hồ Thông minh Y95, C80, Q12S, K9, C90, LT31, D31, TD26, Y8S Kích thước 33mm x39mm Hàng nhập khẩu","""AMA""",https://tiki.vn/product-p199596970.html?spid=199596971,33000,33000,4.8,0,0,10
"Dây sạc Cáp sạc Nam châm Đồng hồ Thông minh Q12, Q16, Q19, Q100, TD26, A28, DS60, DS66, Y95, D06, DF39 Hàng nhập khẩu","""AMA""",https://tiki.vn/product-p68985833.html?spid=75432935,57000,57000,4.6,0,0,174
Chuột Không Dây HXSJ X50 Plus - Hàng Chính Hãng,"""HXSJ""",https://tiki.vn/product-p56889347.html?spid=56889351,137000,245000,4.3,108000,44,573
Tai Nghe Bluetooth Cao Cấp EQ2 5.3 Pin 7h Âm Thanh Sống Động Bass căng - Hàng Chính Hãng,"""Hoco""",https://tiki.vn/product-p272030678.html?spid=272030682,277000,500000,4.8,223000,45,41
Sạc dự phòng All-in-one dung lượng 15000mAh Remax RPP-276 - Hàng chính hãng,"""Remax""",https://tiki.vn/product-p207789733.html?spid=263274832,789999,1199999,4.0,410000,34,1
Chuột Có Dây Logitech M100R - Hàng Chính Hãng,"""Logitech""",https://tiki.vn/product-p370998.html?spid=217143448,119000,119000,5.0,0,0,3
CÂY CHỌC SIM ĐIỆN INOX - QUE CHỌC SIM INOX HÌNH GIỌT NƯỚC,"""OEM""",https://tiki.vn/product-p133637826.html?spid=193714734,1000,3000,5.0,2000,67,4
Bộ Sạc Nhanh 25W Dành Cho Samsung Chân Cắm Type C,"""OEM""",https://tiki.vn/product-p105209267.html?spid=116774763,149000,149000,5.0,0,0,3
Chuột không dây Logitech SIGNATURE M650 Wireless/Bluetooth - Hàng Chính Hãng,"""Logitech""",https://tiki.vn/product-p162772687.html?spid=171126752,598000,598000,4.8,0,0,384
"Hub Type C FIRO Và Hub USB FIRO 3.0 Adapter 4in1 - Bộ Chia USB FIRO Ra Nhiều Cổng Kết Nối Chuyển Đổi Cho Laptop,PC, Máy Tính Đa Năng - Hub FIRO Hỗ Trợ Sạc Pin, Kết Nối Đa Năng Ổ Cứng, Bàn Phím, Chuột, Máy In, Thiết Bị Chia Ổ USB - Hàng Chính Hãng","""FIRO""",https://tiki.vn/product-p262031506.html?spid=262031507,157000,319000,5.0,162000,51,14
Chuột không dây Logitech M240 Silent Bluetooth - Hàng chính hãng,"""Logitech""",https://tiki.vn/product-p263354473.html?spid=263354477,312000,389000,4.3,77000,20,23
Tai nghe In Ear Remax RM330 - Hàng chính hãng,"""Remax""",https://tiki.vn/product-p102782859.html?spid=102782861,220000,250000,4.7,30000,12,546
Ốp Lưng Silicon TPU trong suốt GOR cho iPhone 15 / 15 Plus / 15 Pro / 15 Pro Max - Hàng Chính Hãng,"""Gor""",https://tiki.vn/product-p272126499.html?spid=273099540,54999,58888,0.0,3889,7,0
Miếng Lót Chuột FIRO MXL800 EXTENDED - Tấm Lót Chuột Cỡ Lớn 2 Mặt 80cmx40cm - Chất Liệu Da PU Cao Cấp - Tấm Lót Chuột Và Bàn Phím Chơi Game - Tấm Trải Bàn Làm Việc - Hàng Chính Hãng FIRO,"""FIRO""",https://tiki.vn/product-p242665662.html?spid=242665666,97000,229000,4.8,132000,58,79
Dây 2 Đầu HDMI 1.5m Unitek - Cáp Chuyển HDMI Sang HDMI 1.5m - Hàng Chính Hãng,"""Unitek""",https://tiki.vn/product-p32989128.html?spid=174085861,105000,105000,5.0,0,0,10
Ốp lưng kéo nắp hỗ trợ sạc từ tính dành cho iPhone 12 / 13 / 14 / 15 / 12 Pro / 12 Pro Max / 13 Mini / 13 Pro / 13 Pro Max / 14 Plus / 14 Pro / 14 Pro Max / 15 Plus / 15 Pro / 15 Pro Max - Hàng chính hãng,"""Photodesign VN""",https://tiki.vn/product-p196718477.html?spid=209608709,239000,250000,5.0,11000,4,26
Apple Pencil 2 - MU8F2,"""Apple""",https://tiki.vn/product-p123847933.html?spid=7395669,2790000,4890000,5.0,2100000,43,1030
Chuột Không Dây Tĩnh Âm ROBOT M350 - Kết Nối Bluetooth & USB Nano 2.4 GHz - Độ Phân Giải 1600 DPI - Hàng chính hãng,"""Robot""",https://tiki.vn/product-p117974701.html?spid=117974702,189000,349000,4.7,160000,46,24
"Dây đeo thay thế cho vòng đeo tay miband 5 chất liệu  Silicone không thấm nước, bền, đẹp, dễ vệ sinh  màu đen thương hiệu PKCB - Hàng chính hãng","""PKCB""",https://tiki.vn/product-p174294337.html?spid=174294338,38000,90000,4.6,52000,58,35
Bộ Sạc Nhanh Cho Iphone PD20W Hoco C80 chuôi dẹt 2 cổng Usb và Type-C kèm dây sạc Type-C sang iPhone - Hàng chính hãng,"""Hoco""",https://tiki.vn/product-p109888350.html?spid=262859079,142000,165000,5.0,23000,14,3
"Pin Sạc Dự Phòng 10.000mAh ROBOT RT180 - 2 Cổng Sạc Vào Type-C/Micro, Kích Thước Mỏng và Nhẹ - HÀNG CHÍNH HÃNG","""Robot""",https://tiki.vn/product-p68793627.html?spid=69247930,219000,399000,4.7,180000,45,1605
"Chuột Không Dây PIX-LINK P100 Wireless 2.4Ghz Sạc Pin, Chống Ồn, DPI1600 Dùng Cho Máy Tính, Laptop, Tivi-Hàng Chính Hãng","""PIX-LINK""",https://tiki.vn/product-p174593840.html?spid=174593859,105000,230000,4.6,125000,54,166
Cáp sạc nhanh chuẩn PD 20W cho IP Remax RC-183i chiều dài 2m - Hàng chính hãng,"""Remax""",https://tiki.vn/product-p251518071.html?spid=251518072,149000,200000,5.0,51000,26,16
"Lót chuột Logitech Mouse Pad - Đế cao su chống trượt, lướt dễ dàng, bề mặt chống đổ tràn, bền bỉ, nhỏ gọn - Hàng chính hãng","""Logitech""",https://tiki.vn/product-p171939157.html?spid=171939159,189607,249000,4.8,59393,24,133
"Loa Bluetooth 5.0 - [[ Nghe 24h - Phạm Vi 20m, 200m2 ]] - VIVAN VS20 - Hàng Chính Hãng","""vivan""",https://tiki.vn/product-p58547647.html?spid=58547648,1239000,1239000,4.7,0,0,872
Ốp Lưng Trong Suốt Hoco Dành Cho iPhone - Hàng Chính Hãng,"""Hoco""",https://tiki.vn/product-p135410778.html?spid=135410782,86000,86000,4.8,0,0,72
"	 Loa TWS Bluetooth 5.0 VIVAN VS1 – Chống Nước IPX5, Pin 1800mAh, Âm Thanh Sống Động, Hỗ Trợ Thẻ Nhớ SD & USB – HÀNG CHÍNH HÃNG","""vivan""",https://tiki.vn/product-p54385590.html?spid=54385592,439000,439000,4.8,0,0,882
Ốp lưng dẻo trong phong cách mới dành cho iPhone 12 / 13 / 14 / 12 Pro / 12 Pro Max / 13 Pro / 13 Pro Max / 13 Mini / 14 / 14 Max / 14 Pro / 14 Pro Max  - Hàng chính hãng,"""Photodesign VN""",https://tiki.vn/product-p191477357.html?spid=191477359,139000,199000,4.8,60000,30,209
"Giá Đỡ Máy Tính, Laptop Chất Liệu Hợp Kim Nhôm Cao Cấp Xoay 360 Độ. Hỗ Trợ Tản Nhiệt Chống Mỏi Cổ, Vai, Gáy Model FS088 V3.1. Hàng Chính Hãng Tamayoko","""Tamayoko""",https://tiki.vn/product-p215985421.html?spid=215985423,541000,750000,4.8,209000,28,41
Tai Nghe Bluetooth True Wireless Samsung Galaxy Buds2 Pro SM-R510N - Hàng Chính Hãng,"""Samsung""",https://tiki.vn/product-p195523094.html?spid=195523100,2990000,4990000,5.0,2000000,40,19
"Dây Cáp Dù Lõi HDMI 2.1 8K 48Gbps, 4K 165Hz Dài 2M CHOETECH XHH01 Dùng Cho Tivi/ Máy Tính/ Playstation - Hàng Chính Hãng","""CHOETECH""",https://tiki.vn/product-p88798139.html?spid=88798140,229000,390000,4.8,161000,41,393
"Ốp Bảo Vệ Dành Cho Apple Watch Ultra / Apple Watch Series 1-8/SE/SE 2022, Kai.N Curved Glass - Hàng Chính Hãng","""Kain """,https://tiki.vn/product-p262043852.html?spid=262043876,93000,99000,4.5,6000,6,5
"Miếng Lót Chuột Phím Tắt Văn Phòng Cao Cấp , Bàn Di Chuột Công Thức  , Pad Chuột","""OEM""",https://tiki.vn/product-p248655757.html?spid=248655759,51000,51000,4.8,0,0,4
"Dây Đeo Cao Su Miband 3, Miband 4 Dây Đeo Thay Thế Cho Đồng Hồ - Hàng Chính Hãng PKCB","""PKCB""",https://tiki.vn/product-p109961411.html?spid=109961412,33000,80000,4.5,47000,59,75
Dây Cáp Sạc Điện Thoại USB to USB Type C 30W Dài 0.5M Đến 2M CHOETECH AC0001/AC0002/AC0003 - Hàng Chính Hãng,"""CHOETECH""",https://tiki.vn/product-p87212382.html?spid=87212384,109000,150000,4.7,41000,27,60
Dây Cáp Sạc Lightning Cho iPhone Anker PowerLine II 0.9m - A8432 - Hàng Chính Hãng,"""ANKER""",https://tiki.vn/product-p1059892.html?spid=1061964,230000,330000,4.7,100000,30,1242
Cáp sạc nhanh 2.4A và truyền dữ liệu chân type-C Remax Colorful Light RC-152a [Hàng chính hãng],"""Remax""",https://tiki.vn/product-p111031533.html?spid=253128525,98000,200000,3.5,102000,51,2
Cáp Sạc Nhanh ROBOT RCL100 Dành Cho IPHONE/IPAD - Chất Liệu Dây Bện Dù - Chiều Dài 1m - Hàng chính hãng,"""Robot""",https://tiki.vn/product-p124710495.html?spid=124710496,79000,139000,4.8,60000,43,147
Tai Nghe Điện Thoại PKCB323 Thoại Cổng 3.5mm - Hàng Chính Hãng,"""PKCB""",https://tiki.vn/product-p205752358.html?spid=205752359,81000,200000,4.8,119000,60,30
"Giá Đỡ Để Bàn Điện Thoại Di Động, Máy Tính Bảng. Có Thể Xoay 360 Độ Chất Liệu Hợp Kim Nhôm Cao Cấp. Hàng Chính Hãng Tamayoko","""Tamayoko""",https://tiki.vn/product-p212265002.html?spid=212265008,245000,400000,4.8,155000,39,49
Thẻ Nhớ Micro SDXC Samsung Evo Plus U3 130MB/s 512GB New - Hàng Nhập Khẩu,"""Samsung""",https://tiki.vn/product-p173137800.html?spid=173137801,830000,830000,5.0,0,0,71
"Gamepad Không Dây, Tay Cầm Chơi Game Bluetooth Pin Sạc cho máy tính - điện thoại - máy chơi game","""OEM""",https://tiki.vn/product-p214939406.html?spid=216097172,308900,308900,4.0,0,0,3
Cáp Sạc Nhanh và Truyền Dữ Liệu VivuMax M10 đầu sạc Micro dành cho (Samsung/Oppo/Xiaomi/Nokia/Realme/Techno/Vsmart ...) – Hàng Chính Hãng,"""OEM""",https://tiki.vn/product-p155440451.html?spid=155440453,29000,32000,5.0,3000,9,9
Adapter Sạc Anker 323 1C1A 33W USB-A và Type-C A2331 - Hàng Chính Hãng,"""ANKER""",https://tiki.vn/product-p273080551.html?spid=273080558,242000,380000,5.0,138000,36,10
